материалы: micro chip studio
книга: ATmega168 https://www.microchip.com/en-us/product/ATmega168#document-table
http://we.easyelectronics.ru/new/
https://robocraft.ru/

Арифметико логическое устройство: дешефрируется ассемблер в маш. код
-------------------------------------------------------------------------
Статусный регистор: в зависимости от ситуации выставляется то или иное значение
Программный контроллер: Метки, переход по программе
Флэш-память(ПЗУ): туда загружается скомпилированная программа
Регистр инструкций: 
Декодирование: 
ОЗУ (опер. зап. устр.):
EEPROM: (англ. Electrically Erasable Programmable Read-Only Memory) — электрически стираемое перепрограммируемое ПЗУ (ЭСППЗУ), один из видов энергонезависимой памяти (таких, как PROM и EPROM).
IO Module n, n from {1, ..., 8} - сколько ножек
Watchdog timer: таймер от зависания, автоматический сброс при переполнении
Analog comparator: сравнивает анал. напряж. с пороговым
SPI Unit: Интерфейс


 7  6  5  4  3  2  1  0
[I][T][H][S][V][N][Z][C]

I - общее разрешение прерываний 
T - хранение копируемого бита
H - флаг половинного переноса
S - флаг знака
V - переполнения
N - флаг отрицательного значения
Z - флаг нуля
C - перенос

* на лабе понадобится статусные регистры. Их 32 регистра


разбор операций арифметических

(a + b) / c * d 